XXXXXXXXXXXXXXXXXXXXX
X.....X..XXXX.......X
..XXX.X.XXXXX.XXXXX.X
X..X..X...XX..X.X...X
X.XXXXXXX.XXX.X.X.XXX
X...X..X....X...X.X.X
XXX.X.XXX.X.X.XXX.X.X
X.....X...X...X......
X.XXXXX.X.XXXXX.XXXXX
X.......X...X.......X
XXXXXXXXXXXXXXXXXXXXX
