........
.XXXXXX.
.X....X.
.X....X.
.X......
.X....X.
.XXXXXX.
........
